,iso3,country,tab_cities,geo_cities,diff
0,ARG,Argentina,196,970,774
1,BOL,Bolivia,27,153,126
3,CHL,Chile,94,136,42
4,COL,Colombia,215,934,719
5,ECU,Ecuador,63,122,59
6,GUF,French Guiana,5,18,13
7,GUY,Guyana,3,15,12
8,PRY,Paraguay,20,142,122
9,PER,Peru,106,1290,1184
10,SUR,Suriname,2,13,11
11,TTO,Trinidad and Tobago,10,22,12
12,URY,Uruguay,30,123,93
13,VEN,Venezuela,102,367,265
